PPPPPPPPPPPPPPPPPPPPPPPP
P                      P
P  J                   P
P                      P
P     M                P
P                      P
P          P           P
P          P           P
P          P           P
P          P           P
P          P           P
P                      P
P                E     P
P                      P
P             V        P
PPPPPPPPPPPPPPPPPPPPPPPP