PPPPPPPPPPPPPPPPPPPPPPPP
P  P     P     P     P P
P  P  M  P  M  P  M  P P
P  P     P     P     P P
P  PPPPPPPPPPPPPPPPPPP P
P                      P
P  PPPPPPPPPPPPPPPPPPP P
P  P     P     P     P P
P  P  M  P  J  P  M  P P
P  P     P     P     P P
P  PPPPPPPPPPPPPPPPPPP P
P                      P
P  PPPPPPPPPPPPPPPPPPP P
P  P     P  E  P     P P
P  P  V  P     P  V  P P
PPPPPPPPPPPPPPPPPPPPPPPP