PPPPPPPPPPPPPPPPPPPPPPPP
P  P     P            P
P  P  J  P     M      P
P  P     P            P
P  PPPPPPP            P
P                     P
P  PPPPPPPPPPPPPPP    P
P                P    P
P                P    P
P                P    P
P  M             P    P
P                P    P
P                P    P
P           E    P    P
P   V            P    P
PPPPPPPPPPPPPPPPPPPPPPPP