PPPPPPPPPPPPPPPPPPPPPPPP
P  M                  P
P                     P
P  M                  P
P                     P
P  M                  P
P                     P
P  M                  P
P                     P
P  M                  P
P                     P
P  M                  P
P                     P
P  M       J   E      P
P             V       P
PPPPPPPPPPPPPPPPPPPPPPPP