PPPPPPPPPPPPPPPPPPPPPPPP
P           P          P
P    J      P    M     P
P           P          P
P                      P
P                      P
P  PP   PPPP  PPPP     P
P                P     P
P           M    P     P
P                P     P
P  M             P     P
P                P     P
P                P     P
P           E          P
P   V                  P
PPPPPPPPPPPPPPPPPPPPPPPP